7 0 0 0 0 7
0 0 7 7 0 0
0 7 7 5 7 0
2 7 7 7 7 0
0 0 7 7 0 0
7 0 0 0 0 7